R 960 520
#R 1920 1080

NO ./textures/wall_cartoon_1.XPM
SO ./textures/wall_cartoon_2.XPM
WE ./textures/wall_2.xpm
EA ./textures/wall_cartoon_4.XPM

S ./textures/sprite_1.xpm
F 220,100,0
C 225,30,0

        1111111111111111111111111
        1000000000110000000000001
        1011000001110000002000001
        1001000000000000000000001
111111111011000001110000000000001
100000000011000001110111111111111
11110111111111011100000010001
11110111111111011101010000001
11000000110101011100000010001
10002000000000001100000010001
10000000000000001101010010001
11000001110101011111011110N0111
11110111 1110101 101111010001
11111111 1111111 111111111111
