R 960 520

NO ./textures/wall_cartoon_1.XPM
SO ./textures/key.xpm
WE ./textures/gold.xpm
EA ./textures/wall_cartoon_4.XPM

S1 ./textures/sprite_1.xpm
S2 ./textures/key.xpm
S3 ./textures/portal.xpm
S4 ./textures/teleport.xpm
S5 ./textures/gg.xpm
S6 ./textures/pine.xpm
S7 ./textures/cactus.xpm
S8 ./textures/monokuma.xpm

F 180,180,18
C ./textures/sky_1.xpm

1111111111111111111111111
1000000000110000000000001
10000000011100000020000011111
10151000000000000000000000061
10111000011100000000000011111
1000000000117707711101111
1111111111111111111101111
1111411111111141110909001
1100000011919101111111111
10000000000000001100000011111
10000000000000000001010000031
11211111111111111111111110111
190000000000000000000008000W1
11111111111111111111111111111
